##################### #############
#...................# #...........#
#...................# #...........#
#...................# #...........#
#........o..........###...........#
#.................................#
#.................................#
#..............###########........#
#..............#.........#........#
#..............|....*..../........#
#..............#.........#........#
#..............###########........#
#.................................#
#.................................#
#######|###########################
      #.#
      #.#
      #.#
      #.#
      #.################
      #................#
      ##################
