##################### #############
#...................# #...........#
#...................# #...........#
#...................# #...........#
#...................###...........#
#.................................#
#.................................#
#.................................#
#.................................#
#.................................#
#.................................#
#.................................#
#.................................#
#.................................#
###################################
