##############             #######################
#............#             #.....................#
#............#             #.....................#
#............#             #.....................#
#............#             #.....................#
#............#             #.....................#
#............#             #.....................#
###########|###########|####..##########....######
#........#...|............|......................#
#........#...#............#......................#
#........#...|............|......................#
#........#...##########|####.....................#
#........|...#       #.....#.....................#
#........#...#       #.....#.....................#
#........#...#       #.....#.....................#
#........#...#       #.....#.....................#
#........#...#       #.....#.....................#
##########...#       #.....#.....................#
#........#...#       #.....#.....................#
#........#...#       #.....#.....................#
#........#...#       #.....#.....................#
#........#...#       #.....#.....................#
#........|...#       #.....#.....................#
#........#...#       #.....#.....................#
#........#...#########..####.....................#
#........#.......................................#
#........#.......................................#
##################################################
